111111
1P0011
10C011
100111
10E111
100011
1C0111
111111