111111
1P0011
10C011
100111
10E111
111111
