1111111111111111111111111111111111111111111111111111111111111111
100000000C000011100000000C000011100000000C000011100000000C000011
1P00000000011100000000000C000000000000000C000000000000000C000011
1000011111110001100000000C000011100000000C000011100000000C000011
1C00000000000001100000000C000011100000000C000011100000000C000011
1000000000E11111100000000C000011100000000C000011100000000C000011
1111111111111111111111111111111111111111111111111111111111111111
